EA /home/idakhlao/42cursus/cub3d/textures/ekko-et-powder-qui-dance.xpm
NO /home/idakhlao/42cursus/cub3d/textures/ekko-end.xpm
WE /home/idakhlao/42cursus/cub3d/textures/ekko_alone.xpm
SO /home/idakhlao/42cursus/cub3d/textures/ekko-et-powder-troll.xpm

F128,128,128
C 135,206,250
11111111111111111111111111
100000000000000000000000001
1000000000000000000000000001
10000000000000110000000000001
10000000000000000000000000N001
1000000000000000000000000000001
111111111111111111111111111111