NO ./textures/ekko_alone.xpm
SO ./textures/ekko-et-powder-troll.xpm
WE ./textures/ekko-end.xpm
EA ./textures/ekko-et-powder-qui-dance.xpm

F 	 	 	 	 	128,128,128
C 				  255,69,0

1111111111111111111111111111111111111111
10000000000000000000000000000000000S0001
1000000000000000000000000000000000000001
1000000000000011000000000000011000000001
1000000000000000000000000000000000000001
1000000000000000000000000000000000000001
1111111111111111111111111111111111111111
