NO /home/samy/42/CUB_PUSH/textures/bluestone.xpm
SO /home/samy/42/CUB_PUSH/textures//eagle.xpm
WE /home/samy/42/CUB_PUSH/textures//purplestone.xpm
EA /home/samy/42/CUB_PUSH/textures//redbrick.xpm

F 	 	 	 	 	220,100,0   	 	
C 				  225,30,0 		 	 	


1111111111111111111111111           111
1000000000110000000000001           101
1011000001110000000000001           101
10010000000000000000000011111111    111
111111111011000001110000000000001
10000000001100000111011111111111
11110111111111011100000010001
11110111111111011101010010001
11000000110101011100000010001
100000000000000011000S0010001
10000000000000001101010010001
110000011101010111110111100111
11110111 1110101 101111010001
11111111 1111111 111111111111
