NO 	      ./textures/3ekko_alone.xpm
SO ./textures/3ekko-et-powder-troll.xpm
WE 			./textures/3ekko-end.xpm
EA				./textures/3ekko-et-powder-qui-dance.xpm

F 128,128,128
C 135,206,250   	  

1111111111111111111111111111111111111111
1000000000000000000000000000000000000001
1000000000000000000000000000000000000001
100000000000011000000000S000011000000001
1000000000000000000000000000000000000001
1111111111111111111111111111111111111111