NO ./textures/bluestone.xpm
SO ./textures//eagle.xpm
WE ./textures//purplestone.xpm
EA ./textures//redbrick.xpm

F 25,25,25
C 10,10,10	 	 	


111111111111111111111111111111111111111111111111111111111111111111111111111111111111111
100000000000000000000000000000000000000000000000000000000000000000000000000000000000001
101111111110111111111000111111111111111111111111110000000011111111111111111111111110001
101000000010000000001000100000000000000000000001000000000010000000000000000000000010001
101011111010111111101111100011111111111111111011111111111010111111111111111111111010001
101010001010100000001000100010000000000000001010000000000010100000000000000000000010001
101010111010111111111000111110111111111111101011111111111110101111111111111111110010001
101010000000000000001000000000100000000000001010000000000000001000000000000000010010001
101011111111111111101011111111101111111111101011111111111111111011111111111111110010001
101000000000000000001010000000100000000000000010000000000000000000000000000000000010001
101011111111111111111010111111101111111111111010111111111111111111111111111111110010001
101000000000000000000010100000001000000000000010100000000000000000000000000000000010001
101111111111111111111110111111111011111111111110111111111111111111111111111111111110001
1E0000000000000000000000000000000000000000000000000000000000000000000000000000000000001
111111111111111111111111111111111111111111111111111111111111111111111111111111111111111

