

NO ./textures/3ekko_alone.xpm




EA ./textures/3ekko-et-powder-qui-dance.xpm




WE ./textures/3ekko-end.xpm


F 220,100,0
SO ./textures/3ekko-et-powder-troll.xpm


                
                
                

C 225,30,0  






        1111111111111111111111111
        1000000000110000000000001
    11111011000001110000000000001
        1001000000000000000000001
1111111*1011000001110000000000001
100000**1011000001110111111111111
11110111111111011100000010001
11110111111111011101010010001
11000000110111011100000010001
10000000000000001100000010001
10000000000000001101010010001
1100000111010101111101111N00111
11110111 1110101 101111010001
11111111 1111111 111111111111





